LinkedInAdventure
An interactive adventure featuring the wonders of LinkedIn by Colin Miller, Julie Meridian, Edward Goldstein, Jemiah Westerman, and Jonathan Newton.
Release 1 / Serial number 121216 / Inform 7 build 6G60 (I6/v6.32 lib 6/12N) SD

Reception Area
You are standing in the middle of a large room with vaulted ceilings. The walls are painted a pleasing shade of blue and decorated with a multitude of posters. There is a half-empty water cooler in the corner and a few chairs strewn about. The receptionist is sitting at a large desk and is working on her computer..

On the Large Desk is a bowl of candy (in which is a piece of candy).

On the water cooler is an empty cup.

You can also see a Glass Door and a Receptionist here.

>unlock door
(with the Cell Phone)
That doesn't seem to fit the lock.

>unlock door with badge
(first taking the badge)
That seems to belong to the Receptionist.

>connect to receptionist
(the Receptionist)
You connect with Receptionist on LinkedIn!

[Your score has just gone up by five points.]

>look webcame
You can't see any such thing.

>ask receptionist about badge
(the Receptionist about the badge)
The receptionist looks at you, puts on a giant fake smile and says "Hello and welcome to Frobozz, how may I help you?"

The receptionist asks "Do I know you?  We're not even connected on LinkedIn."

>ask receptionist about badge
(the Receptionist about the badge)
The receptionist says "I see we're connected on LinkedIn!  Let me get you a temp badge.  Please look at the webcam."

>look at webcam
The receptionist says "Smile!  Ok, that's good." and the printer starts printing before you have a chance to actually smile.
The receptionist hands you a badge.

>unlock door with badge
You must supply a noun.

* * *

>talk to receptionist
(the Receptionist)
The receptionist looks at you, puts on a giant fake smile and says "Hello and welcome to Frobozz, how may I help you?"

>ask receptionist about badge
(the Receptionist about the badge)
The receptionist asks "Do I know you?  We're not even connected on LinkedIn."

>connect to receptionist
(the Receptionist)
You connect with Receptionist on LinkedIn!

[Your score has just gone up by five points.]

>connect with receptionist
(the Receptionist)
You've already connected to Receptionist.

I beg your pardon?

>ask receptionist about badge
(the Receptionist about the badge)
The receptionist says "I see we're connected on LinkedIn!  Let me get you a temp badge.  Please look at the webcam."

* * *

>look at webcam
The receptionist says "Smile!  Ok, that's good." and the printer starts printing before you have a chance to actually smile.
The receptionist hands you a badge.

>inv
You are carrying:
  a badge
  a Cell Phone

>use badge on reader
I only understood you as far as wanting to use the badge.

>l reader
It's a black box with a glowing red light.  Red probably means the door is locked.

>l
Reception Area
You are standing in the middle of a large room with vaulted ceilings. The walls are painted a pleasing shade of blue and decorated with a multitude of posters. There is a half-empty water cooler in the corner and a few chairs strewn about. The receptionist is sitting at a large desk and is working on her computer..

On the Large Desk is a bowl of candy (in which is a piece of candy).

On the water cooler is an empty cup.

You can also see a Glass Door and a Receptionist here.

>l door
The glass door is transparent!  You can see right through it because it's made of glass… It's practically magical.  Attached to it is a card reader.

>open door
It seems to be locked.

>unlock door
What do you want to unlock the Glass Door with?

>unlock door with badge
That doesn't seem to fit the lock.

* * *

>inv
You are carrying:
  a badge
  a Cell Phone

>unlock door with badge
You must supply a second noun.

* * *

>l webcam
The webcam looks like a black ball on a small podium.  The lens is staring back at you.

>turn webcam on
That's not something you can switch.

* * *

>ask receptionist about badge
(the Receptionist about the badge)
The receptionist looks at you, puts on a giant fake smile and says "Hello and welcome to Frobozz, how may I help you?"

The receptionist asks "Do I know you?  We're not even connected on LinkedIn."

>connect to receptionist
(the Receptionist)
You connect with Receptionist on LinkedIn!

[Your score has just gone up by five points.]

>ask receptionist about badge
(the Receptionist about the badge)
The receptionist says "I see we're connected on LinkedIn!  Let me get you a temp badge.  Please look at the webcam."