LinkedInAdventure
An Interactive Fiction by Colin Miller The story headline is "An interactive adventure featuring the wonders of LinkedIn"
Release 1 / Serial number 121213 / Inform 7 build 6G60 (I6/v6.32 lib 6/12N) SD

Darkness
You stand (float?) in what seems to be an empty black void. Your life feels somewhat hallow, as if there's been something missing that you can't quite identify. A dim light receeds to the north, a faint glimmer of hope amidst the darnkess. 

You are likely to be eaten by a Grue.

>click button
Login Screen (in the login button)
A wonderous world of magic awaits you at this special page that reads "LinkedIn" at the top. A login button beckons to you seductively from the side.

>click logout
You can't see any such thing.

>click logout button
You can't see any such thing.

>click login
Login Screen (in the login button)
A wonderous world of magic awaits you at this special page that reads "LinkedIn" at the top. A login button beckons to you seductively from the side.

>click login button
Login Screen (in the login button)
A wonderous world of magic awaits you at this special page that reads "LinkedIn" at the top. A login button beckons to you seductively from the side.

>l
Login Screen (in the login button)
A wonderous world of magic awaits you at this special page that reads "LinkedIn" at the top. A login button beckons to you seductively from the side.

>n
Going that way doesn't really make any sense.

>s
Going that way doesn't really make any sense.

* * *

LinkedInAdventure
An Interactive Fiction by Colin Miller The story headline is "An interactive adventure featuring the wonders of LinkedIn"
Release 1 / Serial number 121213 / Inform 7 build 6G60 (I6/v6.32 lib 6/12N) SD

Darkness
You stand (float?) in what seems to be an empty black void. Your life feels somewhat hallow, as if there's been something missing that you can't quite identify. A dim light receeds to the north, a faint glimmer of hope amidst the darnkess. 

You are likely to be eaten by a Grue.

>take taco
You can't see any such thing.

>n
You stumble into the light.

Enlightenment
Clarity fills your mind as you realize your sole purpose in life is to create an interactive fiction (just like this!) about LinkedIn. You're really not sue where it will go or what it will contain but you feel compelled to pour your life essense into this project. You imagine the rewards will be astounding. The feeling of pure joy of having reached this conclusion is enough to bring a tear to your eye. You try to hold it back, yet fail.

>take taco
What taco? Man, don't you wish there were a taco here?

>search
(Around)
You find a delicious taco.

[Your score has just gone up by ten points.]

>search
(the delicious taco)
You find nothing of interest.

>search around
You find no additional tacos.

>l
Enlightenment
Clarity fills your mind as you realize your sole purpose in life is to create an interactive fiction (just like this!) about LinkedIn. You're really not sue where it will go or what it will contain but you feel compelled to pour your life essense into this project. You imagine the rewards will be astounding. The feeling of pure joy of having reached this conclusion is enough to bring a tear to your eye. You try to hold it back, yet fail.

You can see a delicious taco here.

>take taco
Taken.

>take taco
You already have that.

>inv
You are carrying:
  a delicious taco

>eat taco
You now have no more taco which is a sad thing.

[Your score has just gone down by five points.]

>n
You can't go that way.

* * *

LinkedInAdventure
An Interactive Fiction by Colin Miller The story headline is "An interactive adventure featuring the wonders of LinkedIn"
Release 1 / Serial number 121213 / Inform 7 build 6G60 (I6/v6.32 lib 6/12N) SD

Darkness
You stand (float?) in what seems to be an empty black void. Your life feels somewhat hallow, as if there's been something missing that you can't quite identify. A dim light receeds to the north, a faint glimmer of hope amidst the darnkess. 

You are likely to be eaten by a Grue.

>lick link
That's not a verb I recognise.

>click link
Which do you mean, the login button or the signup button?

* * *

LinkedInAdventure
An Interactive Fiction by Colin Miller The story headline is "An interactive adventure featuring the wonders of LinkedIn"
Release 1 / Serial number 121213 / Inform 7 build 6G60 (I6/v6.32 lib 6/12N) SD

Darkness
You stand (float?) in what seems to be an empty black void. Your life feels somewhat hallow, as if there's been something missing that you can't quite identify. A dim light receeds to the north, a faint glimmer of hope amidst the darnkess. 

You are likely to be eaten by a Grue.

>l self
As good-looking as ever.

>inv
You are carrying nothing.

* * *

LinkedInAdventure
An Interactive Fiction by Colin Miller The story headline is "An interactive adventure featuring the wonders of LinkedIn"
Release 1 / Serial number 121213 / Inform 7 build 6G60 (I6/v6.32 lib 6/12N) SD

Darkness
You stand (float?) in what seems to be an empty black void. Your life feels somewhat hallow, as if there's been something missing that you can't quite identify. A dim light receeds to the north, a faint glimmer of hope amidst the darnkess. 

You are likely to be eaten by a Grue.

>n
You stumble into the light.

Enlightenment
Clarity fills your mind as you realize your sole purpose in life is to create an interactive fiction (just like this!) about LinkedIn. You're really not sure where it will go or what it will contain but you feel compelled to pour your life essense into this project. You imagine the rewards will be astounding. The feeling of pure joy of having reached this conclusion is enough to bring a tear to your eye. You try to hold it back, yet fail.

 To the east is a Vahalla where you can meet your fate. To the West is a pit of snakes. (You probably don't want to go there).

>click link
LinkedIn Homepage
You can see a taco here.

>s
Going that way doesn't really make any sense.

>n
Going that way doesn't really make any sense.

>s
Login Screen
A wonderous world of magic awaits you at this special page that reads "LinkedIn" at the top. A login button beckons to you seductively from the side.

* * *

>n
Going that way doesn't really make any sense.

>click link
Login Screen
A wonderous world of magic awaits you at this special page that reads "LinkedIn" at the top. A login button beckons to you seductively from the side.

>n
Going that way doesn't really make any sense.

* * *

>u
Kennel
Why is this even here? How did you go up from what was basically a room of pure light? Did you float? Looking around you see a bunch of empty cages and some newspaper on the ground.

An awesome puppy.

>pet puppy
You pet the puppy who licks you and wags his tail. How wonderful.

[Your score has just gone up by five points.]

>pet puppy
You continue to pet the puppy who continues to wag his tail excitedly.

>d
Enlightenment
Clarity fills your mind as you realize your sole purpose in life is to create an interactive fiction (just like this!) about LinkedIn. You're really not sue where it will go or what it will contain but you feel compelled to pour your life essense into this project. You imagine the rewards will be astounding. The feeling of pure joy of having reached this conclusion is enough to bring a tear to your eye. You try to hold it back, yet fail.

 To the east is a Vahalla where you can meet your fate. To the West is a pit of snakes. (You probably don't want to go there).

>search
(Around)
You find a delicious taco.

[Your score has just gone up by ten points.]

>eat taco
(first taking the delicious taco)
You now have no more taco which is a sad thing.

[Your score has just gone down by five points.]

>w
Dangerous Pit
For some reason you jumped onto a platform in the center of a pit of snakes. The area is dark and has an opressive feel to it. Hisses come from the snakes below you, but also from the walls. They sound like failure.

You can see some snakes here.

>e
As you attempt to make your way back to enlightenment you accidently trip over your shoe laces and fall into the pit. (bad break)Before you can move, a pile of snakes lashes out at you and sink their teeth into your flesh. Burning pain of poison flashes through your system before your body seizes up. You're only regret is that you never followed through with working on LinkedIn Adventure.

 *** YOU DIED ***

    *** The End ***

In that game you scored -9990 out of a possible 20, in 9 turns.

Would you like to RESTART, RESTORE a saved game, QUIT or UNDO the last command?

* * *

>search
(Around)
You find a delicious taco.

[Your score has just gone up by ten points.]

>pet taco
You can't pet the delicious taco

>pet grue
You can't see any such thing.

>pet myself
You can't pet yourself

>w
Dangerous Pit
For some reason you jumped onto a platform in the center of a pit of snakes. The area is dark and has an opressive feel to it. Hisses come from the snakes below you, but also from the walls. They sound like failure.

You can see some snakes here.

>pet snakes
Before you can move, a pile of snakes lashes out at you and sink their teeth into your flesh. Burning pain of poison flashes through your system before your body seizes up. You're only regret is that you never followed through with working on LinkedIn Adventure.

 *** YOU DIED ***

    *** The End ***

In that game you scored -9990 out of a possible 20, in 6 turns.

Would you like to RESTART, RESTORE a saved game, QUIT or UNDO the last command?

* * *

>w
Dangerous Pit
For some reason you jumped onto a platform in the center of a pit of snakes. The area is dark and has an opressive feel to it. Hisses come from the snakes below you, but also from the walls. They sound like failure.

You can see some snakes here.

>kick snakes
That's not a verb I recognise.

>attack snakes
Before you can move, a pile of snakes lashes out at you and sink their teeth into your flesh. Burning pain of poison flashes through your system before your body seizes up. You're only regret is that you never followed through with working on LinkedIn Adventure.

 *** YOU DIED ***

    *** The End ***

In that game you scored -10000 out of a possible 20, in 3 turns.

Would you like to RESTART, RESTORE a saved game, QUIT or UNDO the last command?

* * *

>w
Dangerous Pit
For some reason you jumped onto a platform in the center of a pit of snakes. The area is dark and has an opressive feel to it. Hisses come from the snakes below you, but also from the walls. They sound like failure.

You can see some snakes here.

>attack snakes
Before you can move, a pile of snakes lashes out at you and sink their teeth into your flesh. Burning pain of poison flashes through your system before your body seizes up. You're only regret is that you never followed through with working on LinkedIn Adventure.

 *** YOU DIED ***

    *** The End ***

In that game you scored -10000 out of a possible 20, in 3 turns.

Would you like to RESTART, RESTORE a saved game, QUIT or UNDO the last command?

* * *

>w
Dangerous Pit
For some reason you jumped onto a platform in the center of a pit of snakes. The area is dark and has an opressive feel to it. Hisses come from the snakes below you, but also from the walls. They sound like failure.

You can see some snakes here.

>e
As you attempt to make your way back to enlightenment you accidently trip over your shoe laces and fall into the pit. (bad break)Before you can move, a pile of snakes lashes out at you and sink their teeth into your flesh. Burning pain of poison flashes through your system before your body seizes up. You're only regret is that you never followed through with working on LinkedIn Adventure.

 *** YOU DIED ***

    *** The End ***

In that game you scored -10000 out of a possible 20, in 3 turns.

Would you like to RESTART, RESTORE a saved game, QUIT or UNDO the last command?

>w
Dangerous Pit

>touch snake
You can't see any such thing.

>get snake
You can't see any such thing.

* * *

>w
Dangerous Pit
For some reason you jumped onto a platform in the center of a pit of snakes. The area is dark and has an opressive feel to it. Hisses come from the snakes below you, but also from the walls. They sound like failure.

You can see some snakes here.

>get snake
You can't see any such thing.

>l
Dangerous Pit
You can see some snakes here.

>take snakes
Before you can move, a pile of snakes lashes out at you and sink their teeth into your flesh. Burning pain of poison flashes through your system before your body seizes up. You're only regret is that you never followed through with working on LinkedIn Adventure.

 *** YOU DIED ***

    *** The End ***

In that game you scored -10000 out of a possible 20, in 4 turns.

Would you like to RESTART, RESTORE a saved game, QUIT or UNDO the last command?

* * *

LinkedInAdventure
An Interactive Fiction by Colin Miller The story headline is "An interactive adventure featuring the wonders of LinkedIn"
Release 1 / Serial number 121213 / Inform 7 build 6G60 (I6/v6.32 lib 6/12N) SD

Darkness
You stand (float?) in what seems to be an empty black void. Your life feels somewhat hallow, as if there's been something missing that you can't quite identify. A dim light receeds to the north, a faint glimmer of hope amidst the darnkess. 

You are likely to be eaten by a Grue.

>click exit
Office
This is a standard computer office. There's a desk with a computer and a chair on it.