It's a new day, much like any other day at Frobozz Industries. It's 8:55am and you are mildly delirious from lack of sleep. You spent the previous evening waiting in line to get a new phone, which is quite possibly the most interesting thing to have happened since the last time you got a new phone. You idly wonder if you can convince your boss to expense it as you glance down at it in your hand, feeling very clever for getting the LinkedIn app so you can have a reason to use it at work. Or, at least you can pretend to be while you're surreptitiously tending your virtual garden during the staff meeting. 

Please press SPACE to continue.

>Joe
Thank you joe

* * *

LinkedInAdventure
An interactive adventure featuring the wonders of LinkedIn by Colin Miller, Julie Meridian, Edward Goldstein, Jemiah Westerman, and Jonathan Newton.
Release 1 / Serial number 121214 / Inform 7 build 6G60 (I6/v6.32 lib 6/12N) SD

Reception Area
You are standing in the middle of a large room with vaulted ceilings. The walls are painted a pleasing shade of blue and decorated with a multitude of posters. There is a half-empty water cooler in the corner and a few chairs strewn about. The receptionist is sitting at a large desk and is working on her computer..

On the Large Desk is a bowl of candy (in which is a piece of candy).

On the water cooler is an empty cup.

You can also see a Glass Door and a Receptionist here.

>use cell
You open up the LinkedIn Application.

LinkedIn Homepage
You can see a soft taco here.

* * *

LinkedInAdventure
An interactive adventure featuring the wonders of LinkedIn by Colin Miller, Julie Meridian, Edward Goldstein, Jemiah Westerman, and Jonathan Newton.
Release 1 / Serial number 121214 / Inform 7 build 6G60 (I6/v6.32 lib 6/12N) SD

Reception Area
You are standing in the middle of a large room with vaulted ceilings. The walls are painted a pleasing shade of blue and decorated with a multitude of posters. There is a half-empty water cooler in the corner and a few chairs strewn about. The receptionist is sitting at a large desk and is working on her computer..

On the Large Desk is a bowl of candy (in which is a piece of candy).

On the water cooler is an empty cup.

You can also see a Glass Door and a Receptionist here.

>l water
The water cooler stands half-empty in the corner placidly. You feel its non-existent eyes boring into you.  A Plastic cup sit on top of it.  A bubble gurgles up to the top making a loud noise.

On the water cooler is an empty cup.

>take cup
Taken.

>l water
The water cooler stands half-empty in the corner placidly. You feel its non-existent eyes boring into you.    A bubble gurgles up to the top making a loud noise.

>fill cup
You fill the cup.

>drink water
Delicious.

>drink water
You do not have any water.

* * *

>use badge
Maybe you should try swiping it at something

>n
(first opening the Glass Door)

Outside Of The Elevator
Before you is a pair of ominous silver metal sliding door sealed tightly. On the right hand side are four glowing buttons. A soft feminine voice says "Please make your selection from the following menu."

You can see a Glass Door, Up Button, Down Button, Dance Button and Connect Button here.

[Your score has just gone up by six points.]

>use badge
You can't see any such thing.

>s
Reception Area
You are standing in the middle of a large room with vaulted ceilings. The walls are painted a pleasing shade of blue and decorated with a multitude of posters. There is a half-empty water cooler in the corner and a few chairs strewn about. The receptionist is sitting at a large desk and is working on her computer..

On the Large Desk is a bowl of candy (in which is a piece of candy).

On the water cooler is an empty cup.

You can also see a Glass Door, a Receptionist and a badge here.

>get badge
Taken.

>use badge
Maybe you should try swiping it at something

>use badge on card reader
I only understood you as far as wanting to use the badge.

* * *

>take cup
You take a cup from the top of the stack.

>take cup
(the empty cup)
You already have that.

>take new cup
You can't see any such thing.

>take cup from cooler
You already took one. You don't want to be wasteful.

>fill cup
That's not a verb I recognise.

>take water
You fill your cup.

>inv
You are carrying:
  a cup full of water
  a Cell Phone

>drink water
There's nothing suitable to drink here.

>drink water in cup
I only understood you as far as wanting to drink the water cooler.

>drink cup
(the cup full of water)
Delicious

>inv
You are carrying:
  an empty cup
  a Cell Phone

>take water
You fill your cup.

>take water
You spill water everywhere.

>l
Reception Area
You are standing in the middle of a large room with vaulted ceilings. The walls are painted a pleasing shade of blue and decorated with a multitude of posters. There is a half-empty water cooler in the corner and a few chairs strewn about. The receptionist is sitting at a large desk and is working on her computer..

On the Large Desk is a bowl of candy (in which is a piece of candy).

You can also see a Glass Door and a Receptionist here.

* * *

>take cup
You take a cup from the top of the stack.

>fill cup
(the empty cup)
You fill the cup.

>drink water
There's nothing suitable to drink here.

>drink from cup
You can't see any such thing.

>drink
What do you want to drink?

>drink water
There's nothing suitable to drink here.

>drink
What do you want to drink?

>inv
You are carrying:
  a cup full of water
  a Cell Phone

>drink
What do you want to drink?

>n
You must name something more substantial.

>n
(first opening the Glass Door)

Outside Of The Elevator
Before you is a pair of ominous silver metal sliding door sealed tightly. On the right hand side are four glowing buttons. A soft feminine voice says "Please make your selection from the following menu."

You can see Down Button, Up Button, a Glass Door, Dance Button and Connect Button here.

>d
The Basement Junction
The doors open into a circular room. Water drips from the mildewed walls. The room smells of failed business proposals and shattered LIX experiments.  Hallways leading  East, West, and North branch off from this room In the center of the room stands a security guard. The guard is wearing plate mail (formed of large white paper plates) and armed with an umbrella. His helmet was cut from a waste paper basket. He looks down on you and speaks "Choose your direction wisely adventurer for your fate and the fate of all LinkedIn members depend on you."

You can see Down Button, a basement ceiling, a basement floor and a basement walls here.

>n
You can't go that way.

>u
Outside Of The Elevator
Before you is a pair of ominous silver metal sliding door sealed tightly. On the right hand side are four glowing buttons. A soft feminine voice says "Please make your selection from the following menu."

You can see Down Button, Up Button, a Glass Door, Dance Button and Connect Button here.

>u
Fancy Hallway
This hallway is really fancy. You're not sure you're dressed appropriately for such a hallway. It appears that more craftsmanship went into the floor trim than was applied to the entire building that you grew up in. Pictures on the wall feature people and still life. The area is bathed in a soft yellow light. At the east end of the hallway is the High Five Zone.

You can see Up Button here.

* * *

>get badge
Taken.

* * *

>use
What do you want to use?

>use cell
You open up the LinkedIn Application.

Login Screen
A wonderous world of magic awaits you at this special page that reads "LinkedIn" at the top. A login button beckons to you seductively from the side.

>logout
Reception Area
You are standing in the middle of a large room with vaulted ceilings. The walls are painted a pleasing shade of blue and decorated with a multitude of posters. There is a half-empty water cooler in the corner and a few chairs strewn about. The receptionist is sitting at a large desk and is working on her computer..

On the Large Desk is a bowl of candy (in which is a piece of candy).

On the water cooler is an empty cup.

You can also see a Glass Door and a Receptionist here.

* * *

>l receptionist
(the Receptionist)
The receptionist has short blonde hair and is quite pretty.  She is wearing a nice dress with flower print.  Her name tag reads "Rebecca".  She is ignoring you with such skill that it is quite obvious that she has perfected the art.

>ask receptionist for badge
(the Receptionist for the badge)
The Receptionist has better things to do.

* * *

>fill cup
You take a cup from the top of the stack.

>fill cup
(the cups)
You already took one. You don't want to be wasteful.

* * *

>n
(first opening the Glass Door)

Outside Of The Elevator
Before you is a pair of ominous silver metal sliding door sealed tightly. On the right hand side are four glowing buttons. A soft feminine voice says "Please make your selection from the following menu."

You can see a Glass Door, Up Button, Down Button, Dance Button and Connect Button here.

>press up button
The button lights up and chimes softly. The elevator quietly ascends.

Fancy Hallway
This hallway is really fancy. You're not sure you're dressed appropriately for such a hallway. It appears that more craftsmanship went into the floor trim than was applied to the entire building that you grew up in. Pictures on the wall feature people and still life. The area is bathed in a soft yellow light. At the east end of the hallway is the High Five Zone.

* * *

>n
(first opening the Glass Door)

Outside Of The Elevator
Before you is a pair of ominous silver metal sliding door sealed tightly. On the right hand side are four glowing buttons. A soft feminine voice says "Please make your selection from the following menu."

You can see a Glass Door, Up Button, Down Button, Dance Button and Connect Button here.

>u
Fancy Hallway
This hallway is really fancy. You're not sure you're dressed appropriately for such a hallway. It appears that more craftsmanship went into the floor trim than was applied to the entire building that you grew up in. Pictures on the wall feature people and still life. The area is bathed in a soft yellow light. At the east end of the hallway is the High Five Zone.

>e
High Five Zone
You are in the high five zone of the fancy hallway.  Apart from the standard fancy here is a poster with the title "High Fives Saves Lives" on the wall.  A few feet away from you is a Grue with his hand up looking at you expectantly.

You can see a Grue here.

>w
The grue is offended that you left him hanging. 

 You were eaten by a Grue.

    *** The End ***

In that game you scored -5 out of a possible 20, in 4 turns.

Would you like to RESTART, RESTORE a saved game, QUIT or UNDO the last command?

>undo
High Five Zone
[Previous turn undone.]

>login
That's not a verb I recognise.

>use cell
You open up the LinkedIn Application.

Login Screen
A wonderous world of magic awaits you at this special page that reads "LinkedIn" at the top. A login button beckons to you seductively from the side.

>logout
High Five Zone
You are in the high five zone of the fancy hallway.  Apart from the standard fancy here is a poster with the title "High Fives Saves Lives" on the wall.  A few feet away from you is a Grue with his hand up looking at you expectantly.

You can see a Grue here.

>e
You can't go that way.

>w
The grue is offended that you left him hanging. 

 You were eaten by a Grue.

    *** The End ***

In that game you scored -5 out of a possible 20, in 7 turns.

Would you like to RESTART, RESTORE a saved game, QUIT or UNDO the last command?

>undo
High Five Zone
[Previous turn undone.]

* * *

>e
High Five Zone
You are in the high five zone of the fancy hallway.  Apart from the standard fancy here is a poster with the title "High Fives Saves Lives" on the wall.  A few feet away from you is a Grue with his hand up looking at you expectantly.

You can see a Grue here.

>e
You can't go that way.

>w
hi
Fancy Hallway
This hallway is really fancy. You're not sure you're dressed appropriately for such a hallway. It appears that more craftsmanship went into the floor trim than was applied to the entire building that you grew up in. Pictures on the wall feature people and still life. The area is bathed in a soft yellow light. At the east end of the hallway is the High Five Zone.

You can see Up Button here.

* * *

>e
High Five Zone
You are in the high five zone of the fancy hallway.  Apart from the standard fancy here is a poster with the title "High Fives Saves Lives" on the wall.  A few feet away from you is a Grue with his hand up looking at you expectantly.

You can see a Grue here.

>high five grue
You high five the Grue with a resounding clap!

[Your score has just gone up by one point.]

>high five grue
There's an uncomfortable pause and the Grue coughs quietly.

You were eaten by a Grue.

    *** The End ***

In that game you scored 1 out of a possible 20, in 5 turns.

Would you like to RESTART, RESTORE a saved game, QUIT or UNDO the last command?

* * *

>u
Fancy Hallway
This hallway is really fancy. You're not sure you're dressed appropriately for such a hallway. It appears that more craftsmanship went into the floor trim than was applied to the entire building that you grew up in. Pictures on the wall feature people and still life. The area is bathed in a soft yellow light. At the east end of the hallway is the High Five Zone.

>d
Outside Of The Elevator
Before you is a pair of ominous silver metal sliding door sealed tightly. On the right hand side are four glowing buttons. A soft feminine voice says "Please make your selection from the following menu."

You can see a Glass Door, Up Button, Down Button, Dance Button and Connect Button here.

>d
The Basement Junction
The doors open into a circular room. Water drips from the mildewed walls. The room smells of failed business proposals and shattered LIX experiments.  Hallways leading  East, West, and North branch off from this room In the center of the room stands a security guard. The guard is wearing plate mail (formed of large white paper plates) and armed with an umbrella. His helmet was cut from a waste paper basket. He looks down on you and speaks "Choose your direction wisely adventurer for your fate and the fate of all LinkedIn members depend on you."

You can see a basement ceiling, a basement floor and a basement walls here.

>d
You can't go that way.

* * *

>u
Outside Of The Elevator
Before you is a pair of ominous silver metal sliding door sealed tightly. On the right hand side are four glowing buttons. A soft feminine voice says "Please make your selection from the following menu."

You can see a Glass Door, Up Button, Down Button, Dance Button and Connect Button here.

* * *

>n
(first opening the Glass Door)

Outside Of The Elevator
Before you is a pair of ominous silver metal sliding door sealed tightly. On the right hand side are four glowing buttons. A soft feminine voice says "Please make your selection from the following menu."

You can see a Glass Door, Up Button, Down Button, Dance Button and Connect Button here.

>press connect
A soft feminine voice says "Thank you for adding me to your profesional network. Can you write me a recommendation?"

[Your score has just gone up by five points.]

>press connect
Nothing obvious happens.

>press dance
The elevator begins playing a muzak version of Gangnam Style. You half-heartedly dance in place and sing along.

* * *

>n
(first opening the Glass Door)

Outside Of The Elevator
Before you is a pair of ominous silver metal sliding door sealed tightly. On the right hand side are four glowing buttons. A soft feminine voice says "Please make your selection from the following menu."

You can see a Glass Door, Up Button, Down Button, Dance Button and Connect Button here.

>push up
(Up Button)
hi

* * *

>go door
(first opening the Glass Door)

Outside Of The Elevator
Before you is a pair of ominous silver metal sliding door sealed tightly. On the right hand side are four glowing buttons. A soft feminine voice says "Please make your selection from the following menu."

You can see Down Button, Up Button, a Glass Door, Dance Button and Connect Button here.

* * *

>Colin
Thank you. colin

>s
Office
This is a standard computer office. There's a desk with a computer and a chair on it.

>s
Graveyard
This small patch of overgrown land has a series of well worn stone markers indicating the final resting place of many failed projects.

You can see a shiny gravestone and a damaged gravestone here.

>l shiny
R.I.P. colin

>restart
Are you sure you want to restart?