LinkedInAdventure
An interactive adventure featuring the wonders of LinkedIn by Colin Miller, Julie Meridian, Edward Goldstein, Jemiah Westerman, and Jonathan Newton.
Release 1 / Serial number 121217 / Inform 7 build 6G60 (I6/v6.32 lib 6/12N) SD

Reception Area
You are standing in the middle of a large room with vaulted ceilings. The walls are painted a pleasing shade of blue and decorated with a multitude of posters. There is a half-empty water cooler in the corner and a few chairs strewn about. The receptionist is sitting at a large desk and is working on her computer..

On the Large Desk is a bowl of candy (in which is a piece of candy).

On the water cooler is an empty cup.

You can also see a Glass Door and a Receptionist here.

* * *

Reception Area
You are standing in the middle of a large room with vaulted ceilings. The walls are painted a pleasing shade of blue and decorated with a multitude of posters. The company logo on the wall boldy reads: "Qwerty Fizzbuzz". There is a half-empty water cooler in the corner and a few chairs strewn about. The receptionist is sitting at a large desk and is working on her computer..

On the Large Desk is a bowl of candy (in which is a piece of candy).

On the water cooler is an empty cup.

You can also see a Glass Door and a Receptionist here.

>e
You can't go that way.

>l nameplate
You can't see any such thing.

* * *

>e
You can't go that way.

>l at janitor cart
The Janitor Cart has some rags, various chemicals, some brushes, and a garbage can on it.

On the Janitor Cart are Rags, some chemicals, Brushes, a garbage can (empty) and Janitor keys.

* * *

>e
You can't go that way.

>l cart
The Janitor Cart has some rags, various chemicals, some brushes, and a garbage can on it.

On the janitor cart are Rags, some chemicals, Brushes and a garbage can (empty).

You also see some janitor keys on the cart.

>l
End Of The Hallway
The hallway ends at a large mahogany door. A nameplate is attached to the wall beside it. In one corner, a janitor cart with rags, chemicals, brushes, and a garbage can has been left abandoned.

On the janitor cart are a janitor keys, Rags, some chemicals, Brushes and a garbage can (empty).

>get keys
Taken.

>get rags
Taken.

>get chemicals
Taken.

>get brush
You can't see any such thing.

>get brushes
Taken.

>get can
That's fixed in place.

>inv
You are carrying:
  Brushes
  some chemicals
  Rags
  a janitor keys

* * *

>e
You can't go that way.

>open door
It seems to be locked.

>l door
This large door is made of solid mahogany. In contrast with the higher-tech badge system used on the front door, this door features a simple keyhole attached to what you assume is a dead-bolt.

>get keys
You can't see any such thing.

>l cart
The Janitor Cart has some rags, various chemicals, some brushes, and a garbage can on it.

On the janitor cart are rags, some chemicals, brushes and a garbage can (empty).

You also see some janitor keys on the cart.

>get keys
Taken.

>unlock door
(with the janitor keys)
You unlock the mahogany door.

>open door
You open the mahogany door.

>go door
The Office of the CFO

* * *

>l door
This large door is made of solid mahogany. In contrast with the higher-tech badge system used on the front door, this door features a simple keyhole attached to what you assume is a dead-bolt.

>l rag
You can't see any such thing.

>l at rag
You can't see any such thing.

>exampine rags
That's not a verb I recognise.

>examine rags
You see nothing special about rags.

* * *

Reception Area
You are standing in the middle of a large room with vaulted ceilings. The walls are painted a pleasing shade of blue and decorated with a multitude of posters. The company logo on the wall boldy reads: "Qwerty Fizzbuzz". There is a half-empty water cooler in the corner and a few chairs strewn about. The receptionist is sitting at a large desk and is working on her computer..

On the Large Desk is a bowl of candy (in which is a piece of candy).

On the water cooler is an empty cup.

You can also see a Glass Door and a Receptionist here.

>l cart
You can't see any such thing.

>e
End Of The Hallway
The hallway ends at a large mahogany door. A nameplate is attached to the wall beside it. In one corner, a janitor cart with rags, chemicals, brushes, and a garbage can has been left abandoned.

On the janitor cart are Rags, some chemicals, Brushes, a garbage can (empty) and Janitor keys.

>l cart
The Janitor Cart has some rags, various chemicals, some brushes, and a garbage can on it.

On the janitor cart are Rags, some chemicals, Brushes, a garbage can (empty) and Janitor keys.