LinkedInAdventure
An Interactive Fiction by Colin Miller The story headline is "An interactive adventure featuring the wonders of LinkedIn"
Release 1 / Serial number 121213 / Inform 7 build 6G60 (I6/v6.32 lib 6/12N) SD

Darkness
You stand (float?) in what seems to be an empty black void. Your life feels somewhat hallow, as if there's been something missing that you can't quite identify. A dim light receeds to the north, a faint glimmer of hope amidst the darnkess. 

You are likely to be eaten by a Grue.

Please enter your name

I beg your pardon?

Please enter your name

I beg your pardon?

Please enter your name

>h
Thank you

* * *

LinkedInAdventure
An Interactive Fiction by Colin Miller The story headline is "An interactive adventure featuring the wonders of LinkedIn"
Release 1 / Serial number 121213 / Inform 7 build 6G60 (I6/v6.32 lib 6/12N) SD

Darkness
You stand (float?) in what seems to be an empty black void. Your life feels somewhat hallow, as if there's been something missing that you can't quite identify. A dim light receeds to the north, a faint glimmer of hope amidst the darnkess. 

You are likely to be eaten by a Grue.

Please enter your name

>lick grue
Why would you want to do that to a grue? They're dangerous you know.

>kick grue
That's not a verb I recognise.

>attack grue
Why would you want to do that to a grue? They're dangerous you know.

>eat grue
(first taking the Grue)
Why would you want to do that to a grue? They're dangerous you know.

>lick grue
Why would you want to do that to a grue? They're dangerous you know.

* * *

LinkedInAdventure
An Interactive Fiction by Colin Miller The story headline is "An interactive adventure featuring the wonders of LinkedIn"
Release 1 / Serial number 121213 / Inform 7 build 6G60 (I6/v6.32 lib 6/12N) SD

Darkness
You stand (float?) in what seems to be an empty black void. Your life feels somewhat hallow, as if there's been something missing that you can't quite identify. A dim light receeds to the north, a faint glimmer of hope amidst the darnkess. 

You are likely to be eaten by a Grue.

Please enter your name

>hi
something interestingThat's not a verb I recognise.

Please enter your name

* * *

LinkedInAdventure
An Interactive Fiction by Colin Miller The story headline is "An interactive adventure featuring the wonders of LinkedIn"
Release 1 / Serial number 121213 / Inform 7 build 6G60 (I6/v6.32 lib 6/12N) SD

Darkness
You stand (float?) in what seems to be an empty black void. Your life feels somewhat hallow, as if there's been something missing that you can't quite identify. A dim light receeds to the north, a faint glimmer of hope amidst the darnkess. 

You are likely to be eaten by a Grue.

Please enter your name

>Hi
something interestingThat's not a verb I recognise.

Please enter your name

* * *

LinkedInAdventure
An Interactive Fiction by Colin Miller The story headline is "An interactive adventure featuring the wonders of LinkedIn"
Release 1 / Serial number 121213 / Inform 7 build 6G60 (I6/v6.32 lib 6/12N) SD

Darkness
You stand (float?) in what seems to be an empty black void. Your life feels somewhat hallow, as if there's been something missing that you can't quite identify. A dim light receeds to the north, a faint glimmer of hope amidst the darnkess. 

You are likely to be eaten by a Grue.

Please enter your name

>kick grue
Why would you want to do that to a grue? They're dangerous you know.

>n
You stumble into the light.

Enlightenment
Clarity fills your mind as you realize your sole purpose in life is to create an interactive fiction (just like this!) about LinkedIn. You're really not sure where it will go or what it will contain but you feel compelled to pour your life essense into this project. You imagine the rewards will be astounding. The feeling of pure joy of having reached this conclusion is enough to bring a tear to your eye. You try to hold it back, yet fail.

 To the east is a Vahalla where you can meet your fate. To the West is a pit of snakes. (You probably don't want to go there).

>search
What do you want to search?

>search around
You find a delicious taco.

[Your score has just gone up by ten points.]

>kick taco
Violence isn't the answer to this one.

>lick taco
You lick the delicious taco. It is yours now.

* * *

LinkedInAdventure
An Interactive Fiction by Colin Miller The story headline is "An interactive adventure featuring the wonders of LinkedIn"
Release 1 / Serial number 121213 / Inform 7 build 6G60 (I6/v6.32 lib 6/12N) SD

Darkness
You stand (float?) in what seems to be an empty black void. Your life feels somewhat hallow, as if there's been something missing that you can't quite identify. A dim light receeds to the north, a faint glimmer of hope amidst the darnkess. 

You are likely to be eaten by a Grue.

Please enter your name

>dance
A disco ball descends and you groove.

* * *

LinkedInAdventure
An Interactive Fiction by Colin Miller The story headline is "An interactive adventure featuring the wonders of LinkedIn"
Release 1 / Serial number 121213 / Inform 7 build 6G60 (I6/v6.32 lib 6/12N) SD

Darkness
You stand (float?) in what seems to be an empty black void. Your life feels somewhat hallow, as if there's been something missing that you can't quite identify. A dim light receeds to the north, a faint glimmer of hope amidst the darnkess. 

You are likely to be eaten by a Grue.

Please enter your name

>s
Office
This is a standard computer office. There's a desk with a computer and a chair on it.

>l computer
Sleek and high tech, this construct of keys, screen, and whirring lights allows one to send signals through a series of tubes to remote locations. Truely a marvel of the modern world.

The computer is currently switched off.

>l chair
You see nothing special about the chair.

>lick computer
You lick the computer. It is yours now.

>n
Darkness
You stand (float?) in what seems to be an empty black void. Your life feels somewhat hallow, as if there's been something missing that you can't quite identify. A dim light receeds to the north, a faint glimmer of hope amidst the darnkess. 

You are likely to be eaten by a Grue.

>lick grue
You can't see any such thing.

* * *

LinkedInAdventure
An Interactive Fiction by Colin Miller The story headline is "An interactive adventure featuring the wonders of LinkedIn"
Release 1 / Serial number 121213 / Inform 7 build 6G60 (I6/v6.32 lib 6/12N) SD

Darkness
You stand (float?) in what seems to be an empty black void. Your life feels somewhat hallow, as if there's been something missing that you can't quite identify. A dim light receeds to the north, a faint glimmer of hope amidst the darnkess. 

You are likely to be eaten by a Grue.

Please enter your name

>go into light
You stumble into the light.

Enlightenment
Clarity fills your mind as you realize your sole purpose in life is to create an interactive fiction (just like this!) about LinkedIn. You're really not sure where it will go or what it will contain but you feel compelled to pour your life essense into this project. You imagine the rewards will be astounding. The feeling of pure joy of having reached this conclusion is enough to bring a tear to your eye. You try to hold it back, yet fail.

 To the east is a Vahalla where you can meet your fate. To the West is a pit of snakes. (You probably don't want to go there).

>restart
Are you sure you want to restart?

* * *

LinkedInAdventure
An Interactive Fiction by Colin Miller The story headline is "An interactive adventure featuring the wonders of LinkedIn"
Release 1 / Serial number 121213 / Inform 7 build 6G60 (I6/v6.32 lib 6/12N) SD

Darkness
You stand (float?) in what seems to be an empty black void. Your life feels somewhat hallow, as if there's been something missing that you can't quite identify. A dim light receeds to the north, a faint glimmer of hope amidst the darnkess. 

You are likely to be eaten by a Grue.

Please enter your name

>Some Bloke
That's not a verb I recognise.

Please enter your name

>l
Darkness
You stand (float?) in what seems to be an empty black void. Your life feels somewhat hallow, as if there's been something missing that you can't quite identify. A dim light receeds to the north, a faint glimmer of hope amidst the darnkess. 

You are likely to be eaten by a Grue.

Please enter your name

* * *

LinkedInAdventure
An Interactive Fiction by Colin Miller The story headline is "An interactive adventure featuring the wonders of LinkedIn"
Release 1 / Serial number 121213 / Inform 7 build 6G60 (I6/v6.32 lib 6/12N) SD

Darkness
You stand (float?) in what seems to be an empty black void. Your life feels somewhat hallow, as if there's been something missing that you can't quite identify. A dim light receeds to the north, a faint glimmer of hope amidst the darnkess. 

You are likely to be eaten by a Grue.

Please enter your name

>go towards light
You can't see any such thing.

>go light
You stumble into the light.

Enlightenment
Clarity fills your mind as you realize your sole purpose in life is to create an interactive fiction (just like this!) about LinkedIn. You're really not sure where it will go or what it will contain but you feel compelled to pour your life essense into this project. You imagine the rewards will be astounding. The feeling of pure joy of having reached this conclusion is enough to bring a tear to your eye. You try to hold it back, yet fail.

 To the east is a Vahalla where you can meet your fate. To the West is a pit of snakes. (You probably don't want to go there).

>reset
That's not a verb I recognise.

>restart
Are you sure you want to restart?

* * *

LinkedInAdventure
An Interactive Fiction by Colin Miller The story headline is "An interactive adventure featuring the wonders of LinkedIn"
Release 1 / Serial number 121213 / Inform 7 build 6G60 (I6/v6.32 lib 6/12N) SD

Darkness
You stand (float?) in what seems to be an empty black void. Your life feels somewhat hallow, as if there's been something missing that you can't quite identify. A dim light receeds to the north, a faint glimmer of hope amidst the darnkess. 

You are likely to be eaten by a Grue.

Please enter your name

>Joe
Thank you joe

* * *

LinkedInAdventure
An Interactive Fiction by Colin Miller The story headline is "An interactive adventure featuring the wonders of LinkedIn"
Release 1 / Serial number 121213 / Inform 7 build 6G60 (I6/v6.32 lib 6/12N) SD

Darkness
You stand (float?) in what seems to be an empty black void. Your life feels somewhat hallow, as if there's been something missing that you can't quite identify. A dim light receeds to the north, a faint glimmer of hope amidst the darnkess. 

You are likely to be eaten by a Grue.

Please enter your name

>click exit
Office
This is a standard computer office. There's a desk with a computer and a chair on it.

>l
Office
This is a standard computer office. There's a desk with a computer and a chair on it.

>s
You can't go that way.

* * *

>click exit
Office
This is a standard computer office. There's a desk with a computer and a chair on it.

>e
Bathroom
This bathroom hasn't been cleaned in years.

>w
Office
This is a standard computer office. There's a desk with a computer and a chair on it.

>use computer
That's not a verb I recognise.

>turn computer on
You switch the computer on.

* * *

>click exit
Office
This is a standard computer office. There's a desk with a computer and a chair on it.

>turn computer on
Login Screen
A wonderous world of magic awaits you at this special page that reads "LinkedIn" at the top. A login button beckons to you seductively from the side.

You switch the computer on.

* * *

LinkedInAdventure
An Interactive Fiction by Colin Miller The story headline is "An interactive adventure featuring the wonders of LinkedIn"
Release 1 / Serial number 121213 / Inform 7 build 6G60 (I6/v6.32 lib 6/12N) SD

Darkness
You stand (float?) in what seems to be an empty black void. Your life feels somewhat hallow, as if there's been something missing that you can't quite identify. A dim light receeds to the north, a faint glimmer of hope amidst the darnkess. 

You are likely to be eaten by a Grue.

Please enter your name

>n
You stumble into the light.

Enlightenment
Clarity fills your mind as you realize your sole purpose in life is to create an interactive fiction (just like this!) about LinkedIn. You're really not sure where it will go or what it will contain but you feel compelled to pour your life essense into this project. You imagine the rewards will be astounding. The feeling of pure joy of having reached this conclusion is enough to bring a tear to your eye. You try to hold it back, yet fail.

 To the east is a Vahalla where you can meet your fate. To the West is a pit of snakes. (You probably don't want to go there).

>search around
You find a delicious taco.

[Your score has just gone up by ten points.]

>inv
You are carrying nothing.

>lick taco
You lick the delicious taco. It is yours now.

>inv
You are carrying:
  a delicious taco

>l
Enlightenment
Clarity fills your mind as you realize your sole purpose in life is to create an interactive fiction (just like this!) about LinkedIn. You're really not sure where it will go or what it will contain but you feel compelled to pour your life essense into this project. You imagine the rewards will be astounding. The feeling of pure joy of having reached this conclusion is enough to bring a tear to your eye. You try to hold it back, yet fail.

 To the east is a Vahalla where you can meet your fate. To the West is a pit of snakes. (You probably don't want to go there).

>up
Kennel
Why is this even here? How did you go up from what was basically a room of pure light? Did you float? Looking around you see a bunch of empty cages and some newspaper on the ground.

An awesome puppy.

>lick puppy
I don't suppose the puppy would care for that.

You lick the puppy. It is yours now.

>l
Kennel
Why is this even here? How did you go up from what was basically a room of pure light? Did you float? Looking around you see a bunch of empty cages and some newspaper on the ground.

An awesome puppy.

>inv
You are carrying:
  a delicious taco

I beg your pardon?

>down
Enlightenment
Clarity fills your mind as you realize your sole purpose in life is to create an interactive fiction (just like this!) about LinkedIn. You're really not sure where it will go or what it will contain but you feel compelled to pour your life essense into this project. You imagine the rewards will be astounding. The feeling of pure joy of having reached this conclusion is enough to bring a tear to your eye. You try to hold it back, yet fail.

 To the east is a Vahalla where you can meet your fate. To the West is a pit of snakes. (You probably don't want to go there).

>e
Vahalla
Congradulations! You've decided to work on LinkedIn Adventure! You should send a message to Colin Miller (cmiller@linkedin.com) right away and let him know of your profound commitment to this worth cause. Also, cake!

A delicious looking cake.

>lick cake
You lick the Cake. It is yours now.

>smell cake
You smell nothing unexpected.

* * *

>e
Vahalla
Congradulations! You've decided to work on LinkedIn Adventure! You should send a message to Colin Miller (cmiller@linkedin.com) right away and let him know of your profound commitment to this worth cause. Also, cake!

A delicious looking cake.

>smell cake
The cake smells mouth watering.

>w
Enlightenment
Clarity fills your mind as you realize your sole purpose in life is to create an interactive fiction (just like this!) about LinkedIn. You're really not sure where it will go or what it will contain but you feel compelled to pour your life essense into this project. You imagine the rewards will be astounding. The feeling of pure joy of having reached this conclusion is enough to bring a tear to your eye. You try to hold it back, yet fail.

 To the east is a Vahalla where you can meet your fate. To the West is a pit of snakes. (You probably don't want to go there).

>s
Why would you ever want to go back to that empty void? This place is much better. Look, over there is a puppy! 

Ok, so there wasn't really a puppy, but you can imagine one. I bet if you search around long enough you'll find a taco. Mmm, tacos. There's no tacos in the dark place. Better to stay here.

>s
You still don't want to go that way

>search taco
You find nothing of interest.

>search
What do you want to search?

* * *

>pet taco
You can't pet the delicious taco

*** Run-time problem P10: Since the delicious taco is not allowed the property "been pet", it is against the rules to try to use it.

You continue to pet the puppy who continues to wag his tail excitedly.

I beg your pardon?

* * *

>click login
LinkedIn Homepage
You can see a taco here.

>click logout
Login Screen
A wonderous world of magic awaits you at this special page that reads "LinkedIn" at the top. A login button beckons to you seductively from the side.

>click login
LinkedIn Homepage
You can see a taco here.

>click login
You can't see any such thing.

>click link
Login Screen
A wonderous world of magic awaits you at this special page that reads "LinkedIn" at the top. A login button beckons to you seductively from the side.

>click link
Which do you mean, the login button or the signup button?

* * *

>eat taco
(first taking the delicious taco)
What taco? Man, don't you wish there were a taco here?

>search
(Around)
You find a delicious taco.

[Your score has just gone up by ten points.]

>take taco
Taken.

>up
Kennel
Why is this even here? How did you go up from what was basically a room of pure light? Did you float? Looking around you see a bunch of empty cages and some newspaper on the ground.

An awesome puppy.

>pet puppy
You pet the puppy who licks you and wags his tail. How wonderful.

[Your score has just gone up by five points.]

>down
Enlightenment
Clarity fills your mind as you realize your sole purpose in life is to create an interactive fiction (just like this!) about LinkedIn. You're really not sue where it will go or what it will contain but you feel compelled to pour your life essense into this project. You imagine the rewards will be astounding. The feeling of pure joy of having reached this conclusion is enough to bring a tear to your eye. You try to hold it back, yet fail.

 To the east is a Vahalla where you can meet your fate. To the West is a pit of snakes. (You probably don't want to go there).

>e
Vahalla
Congradulations! You've decided to work on LinkedIn Adventure! You should send a message to Colin Miller (cmiller@linkedin.com) right away and let him know of your profound commitment to this worth cause. Also, cake!

A delicious looking cake.

>take cake
Taken.

>eat cake
You take a bite of the cake and find yourself in nirvana.

    *** The End ***

In that game you scored 20 out of a possible 20, in 10 turns.

Would you like to RESTART, RESTORE a saved game, QUIT or UNDO the last command?

* * *

LinkedInAdventure
An Interactive Fiction by Colin Miller The story headline is "An interactive adventure featuring the wonders of LinkedIn"
Release 1 / Serial number 121213 / Inform 7 build 6G60 (I6/v6.32 lib 6/12N) SD

Darkness
You stand (float?) in what seems to be an empty black void. Your life feels somewhat hallow, as if there's been something missing that you can't quite identify. A dim light receeds to the north, a faint glimmer of hope amidst the darnkess. 

You are likely to be eaten by a Grue.

Please enter your name

>Colin
Thank you. colin