LinkedInAdventure
An Interactive Fiction by Colin Miller
Release 1 / Serial number 121212 / Inform 7 build 6G60 (I6/v6.32 lib 6/12N) SD

Login Screen
A wonderous world of magic awaits you at this special page that reads "LinkedIn" at the top. A login button beckons to you seductively from the side.

You can see a login button here.

>click login
LinkedIn Homepage
You can see a taco here.

>l
Login Screen
You can see a login button here.

>l button
The login button will probably go somewhere if clicked on.

* * *

>click login
LinkedIn Homepage
You can see a taco here.

>click on taco
You cannot click on The taco

* * *

LinkedInAdventure
An Interactive Fiction by Colin Miller
Release 1 / Serial number 121212 / Inform 7 build 6G60 (I6/v6.32 lib 6/12N) SD

Login Screen
A wonderous world of magic awaits you at this special page that reads "LinkedIn" at the top. A login button beckons to you seductively from the side.

You can see a login button here.

>g login
You can hardly repeat that.

>go login
LinkedIn Homepage
You can see a taco here.

>l taco
This taco is made of tasty meat and cheese with a tortilla curled around it.

>eat taco
(first taking the taco)
You eat the taco. Not bad.

>l
LinkedIn Homepage

>l
LinkedIn Homepage

* * *

LinkedInAdventure
An Interactive Fiction by Colin Miller
Release 1 / Serial number 121212 / Inform 7 build 6G60 (I6/v6.32 lib 6/12N) SD

Login Screen
A wonderous world of magic awaits you at this special page that reads "LinkedIn" at the top. A login button beckons to you seductively from the side.

You can see a login button here.

>fuck button
You fuck the login button

>go button
LinkedIn Homepage
You can see a taco here.

>fuck taco
You fuck the taco

* * *

LinkedInAdventure
An Interactive Fiction by Colin Miller
Release 1 / Serial number 121212 / Inform 7 build 6G60 (I6/v6.32 lib 6/12N) SD

Login Screen
A wonderous world of magic awaits you at this special page that reads "LinkedIn" at the top. A login button beckons to you seductively from the side.

You can see a login button here.

>l
LinkedIn Homepage

* * *

LinkedInAdventure
An Interactive Fiction by Colin Miller
Release 1 / Serial number 121212 / Inform 7 build 6G60 (I6/v6.32 lib 6/12N) SD

Login Screen
A wonderous world of magic awaits you at this special page that reads "LinkedIn" at the top. A login button beckons to you seductively from the side.

You can see a login button here.

>blink
You blink.

>shit
Real adventurers do not use such language.

>fuck
Real adventurers do not use such language.

>piss
That's not a verb I recognise.

>pussy
That's not a verb I recognise.

>penis
That's not a verb I recognise.

>cunt
That's not a verb I recognise.

>asshole
That's not a verb I recognise.

>cum
That's not a verb I recognise.

>exit
But you aren't in anything at the moment.

* * *

LinkedInAdventure
An Interactive Fiction by Colin Miller
Release 1 / Serial number 121212 / Inform 7 build 6G60 (I6/v6.32 lib 6/12N) SD

Login Screen
A wonderous world of magic awaits you at this special page that reads "LinkedIn" at the top. A login button beckons to you seductively from the side.

You can see a login button here.

>l button
The login button will probably go somewhere if clicked on.

>click on login
LinkedIn Homepage

* * *

>l button
The login button will probably go somewhere if clicked on.

>go button
LinkedIn Homepage
You can see a taco here.

>l
LinkedIn Homepage

* * *

>go button
LinkedIn Homepage
You can see a taco here.

>click taco
the taco is not a thing on which one can click.

* * *

LinkedInAdventure
An Interactive Fiction by Colin Miller
Release 1 / Serial number 121212 / Inform 7 build 6G60 (I6/v6.32 lib 6/12N) SD

Login Screen
A wonderous world of magic awaits you at this special page that reads "LinkedIn" at the top. A login button beckons to you seductively from the side.

You can see a login button here.

>go login
LinkedIn Homepage
You can see a taco here.

>click taco
the taco is not a thing on which can be clicked.

* * *

LinkedInAdventure
An Interactive Fiction by Colin Miller
Release 1 / Serial number 121212 / Inform 7 build 6G60 (I6/v6.32 lib 6/12N) SD

Login Screen
A wonderous world of magic awaits you at this special page that reads "LinkedIn" at the top. A login button beckons to you seductively from the side.

You can see a login button here.

>pussy
Potty mouth.

* * *

LinkedInAdventure
An Interactive Fiction by Colin Miller
Release 1 / Serial number 121212 / Inform 7 build 6G60 (I6/v6.32 lib 6/12N) SD

Login Screen
A wonderous world of magic awaits you at this special page that reads "LinkedIn" at the top. A login button beckons to you seductively from the side.

You can see a login button here.

>fuck
Potty mouth.

>shit
Real adventurers do not use such language.